20 10
3 3 
o..................o
........C...........
..F............P....
....................
....1.X.............
FFFFFFFFFFFFFFFFFFFF
................1...
...D................
....................
o..................o
