20 10
3 3
o..................o
........C...........
..F............P....
....................
....1..........p....
FFFFFFFFFFFFFFFFFFFF
...X.i..........1...
...D................
....................
o..................o
