20 10
3 3
o..................o
....................
..F.................
....................
....1..........p....
FFFFFFF..FFFFFFFFFFF
.....i..............
...D................
..........1.........
o..................o
