20 10
3 3 2
o..................o
....................
..F.................
....................
....1..........p....
FFFF.....FFFFFFFFFFF
.....i..............
...D................
..........1.........
o..................o
22 