20 10
3 3 3
o..................o
........C...........
..F............P....
...T................
...............p....
FFFFFFFFFFFFFFFFFFFF
.....i..............
...F................
....................
o..................o
5000