20 10
3 3 2
o..................o
........C...........
..F............P....
...T................
...............p....
FFFFFFFFFFFFFFFFFFFF
.....i..............
...D................
....................
o..................o
5700 1